{
    "about": {
	    "name": "Lobby - Waiting Room",
        "tags": ["Official"],
        "authors": [{"name": "MrBoomDev"}],
        "banner": "../../ui/banner/gamemode/lobby.png",
        "wallpaper": "../../ui/banner/gamemode/lobby_wallpaper.png"
    },
    
    "ambient": {
        "music": ["../../audio/music/lobby.mp3"],
        "lights": {
            "player": {"values":[20, 50, 250, .8]},
            "scene": {"values":[0, 0, 0, .1]}
        },
    },
    
    "options": {
        "enableDeath": false,
        "session_duration": 6,
        "hide_gui": false,
        "exclude_gamemodes": ["*"]
    },
	
    "load": ["air", "wall", "floor", "game_machine", "barrier", "wall_last", "door", "wall_top", "pizza", "gift", "plush_danya", "chair", "table", "stage"],
	"tiles": {
        "background": [
            [ 00, 00, 00, 00, 02, 02, 02, 02, 02, 02, 02, 02, 02, 02, 02, 02, 02, 02, 02, 02, 02, 00 ],
            [ 00, 00, 00, 00, 00, 02, 02, 02, 02, 02, 02, 02, 02, 02, 02, 02, 02, 02, 02, 02, 02, 00 ],
		    [ 00, 00, 00, 00, 00, 02, 02, 02, 02, 02, 02, 02, 02, 02, 02, 02, 02, 02, 02, 02, 02, 00 ],
		    [ 00, 00, 00, 00, 00, 02, 02, 02, 02, 02, 02, 02, 02, 02, 02, 02, 02, 02, 02, 02, 02, 00 ],
		    [ 00, 00, 00, 00, 00, 02, 02, 02, 02, 02, 02, 02, 02, 02, 02, 02, 02, 02, 02, 02, 02, 00 ],
		    [ 00, 02, 02, 02, 00, 02, 02, 02, 02, 02, 02, 02, 02, 02, 02, 02, 02, 02, 02, 02, 02, 00 ],
		    [ 00, 02, 02, 02, 00, 02, 02, 02, 02, 02, 02, 02, 02, 02, 02, 02, 02, 02, 02, 02, 02, 00 ],
		    [ 00, 02, 02, 02, 02, 02, 02, 02, 02, 02, 02, 02, 02, 02, 02, 02, 02, 02, 02, 02, 02, 00 ],
		    [ 00, 02, 02, 02, 02, 02, 02, 02, 02, 02, 02, 02, 02, 02, 02, 02, 02, 02, 02, 02, 02, 00 ],
		    [ 00, 02, 02, 02, 00, 02, 02, 02, 02, 02, 02, 02, 02, 02, 02, 02, 02, 02, 02, 02, 02, 00 ],
		    [ 00, 02, 02, 02, 00, 02, 02, 02, 02, 02, 02, 02, 02, 02, 02, 02, 02, 02, 02, 02, 02, 00 ],
		    [ 00, 00, 00, 00, 00, 02, 00, 00, 00, 00, 00, 00, 00, 00, 02, 02, 00, 00, 00, 00, 00, 00 ],
            [ 00, 00, 00, 00, 00, 00, 00, 00, 00, 00, 00, 00, 00, 00, 00, 00, 00, 00, 00, 00, 00, 00 ]
	    ],
        
        "foreground": [
            [ 00, 00, 00, 00, 05, 04, 04, 04, 04, 04, 04, 04, 04, 04, 04, 04, 04, 04, 04, 04, 04, 05 ],
            [ 00, 00, 00, 00, 07, 00, 00, 00, 00, 00, 00, 00, 00, 00, 00, 00, 00, 00, 00, 00, 00, 07 ],
		    [ 00, 00, 00, 00, 07, 00, 00, 00, 00, 00, 00, 00, 00, 00, 00, 00, 00, 00, 00, 00, 00, 07 ],
		    [ 00, 00, 00, 00, 07, 00, 00, 00, 00, 00, 00, 00, 00, 00, 00, 00, 00, 00, 00, 09, 00, 07 ],
		    [ 05, 05, 05, 05, 07, 00, 00, 00, 00, 00, 00, 00, 00, 00, 00, 00, 00, 00, 09, 09, 00, 07 ],
		    [ 07, 00, 00, 00, 07, 00, 00, 00, 12, 00, 00, 12, 00, 00, 12, 00, 00, 00, 00, 00, 00, 07 ],
		    [ 07, 00, 00, 00, 07, 00, 00, 00, 00, 00, 00, 00, 00, 00, 00, 00, 00, 00, 00, 00, 00, 07 ],
		    [ 07, 00, 10, 00, 00, 00, 00, 00, 12, 00, 00, 12, 00, 00, 12, 00, 00, 00, 00, 00, 00, 07 ],
		    [ 07, 00, 00, 00, 08, 00, 00, 00, 00, 00, 00, 00, 00, 00, 00, 00, 00, 00, 00, 00, 00, 07 ],
		    [ 07, 00, 00, 00, 01, 00, 00, 00, 00, 00, 00, 00, 00, 00, 00, 00, 00, 00, 00, 00, 00, 07 ],
		    [ 07, 00, 00, 00, 07, 00, 08, 08, 00, 13, 00, 00, 00, 00, 00, 00, 00, 03, 03, 03, 08, 07 ],
		    [ 07, 01, 01, 01, 07, 01, 01, 01, 01, 01, 01, 01, 01, 01, 06, 06, 01, 01, 01, 01, 01, 07 ],
            [ 00, 00, 00, 00, 00, 00, 00, 00, 00, 00, 00, 00, 00, 00, 04, 04, 00, 00, 00, 00, 00, 00 ]
	    ]
    }
}