{
    "about": {
	    "name": "Test 01: Updated 04",
        "duration": 6,
        "tags": ["Test map", "Official"],
        "author": "MrBoomDev",
	    "version": 2
    },
        
    "load": [
        "air",
        "wall",
        "floor",
        "game_machine",
        "barrier",
        "wall_last",
        "door",
        "wall_top"
    ],
	
	"tiles": {
        "background": [
            [ 2, 2, 2, 2, 2, 2, 2, 2, 2, 2, 2, 2, 2, 2, 2 ],
            [ 0, 2, 2, 0, 2, 2, 2, 2, 2, 2, 2, 2, 2, 2, 0 ],
		    [ 0, 2, 2, 0, 2, 2, 2, 2, 2, 2, 2, 2, 2, 2, 0 ],
		    [ 0, 2, 2, 0, 2, 2, 2, 2, 2, 2, 2, 2, 2, 2, 0 ],
		    [ 0, 2, 2, 0, 2, 2, 2, 2, 2, 2, 2, 2, 2, 2, 0 ],
		    [ 0, 2, 2, 2, 2, 2, 2, 2, 2, 2, 2, 2, 2, 2, 0 ],
		    [ 0, 2, 2, 2, 2, 2, 2, 2, 2, 2, 2, 2, 2, 2, 0 ],
		    [ 0, 2, 2, 2, 2, 2, 2, 2, 2, 2, 2, 2, 2, 2, 0 ],
		    [ 0, 2, 2, 0, 2, 2, 2, 2, 2, 2, 2, 2, 2, 2, 0 ],
		    [ 0, 2, 2, 0, 2, 2, 2, 2, 2, 2, 2, 2, 2, 2, 0 ],
		    [ 0, 0, 2, 0, 2, 2, 2, 2, 2, 2, 2, 2, 2, 2, 0 ],
		    [ 0, 0, 0, 0, 0, 2, 2, 2, 0, 0, 0, 0, 0, 0, 0 ],
            [ 0, 0, 0, 0, 0, 0, 0, 0, 0, 0, 0, 0, 0, 0, 0 ]
	    ],
        "foreground": [
            [ 5, 4, 4, 5, 4, 4, 4, 4, 4, 4, 4, 4, 4, 4, 5 ],
            [ 7, 0, 0, 7, 0, 0, 0, 0, 0, 0, 0, 0, 0, 0, 7 ],
		    [ 7, 0, 0, 7, 0, 0, 0, 0, 0, 0, 0, 0, 0, 0, 7 ],
		    [ 7, 0, 0, 7, 0, 0, 0, 0, 0, 0, 0, 0, 0, 0, 7 ],
		    [ 7, 0, 0, 7, 0, 0, 0, 0, 3, 0, 0, 0, 0, 0, 7 ],
		    [ 7, 0, 0, 0, 0, 0, 0, 0, 0, 0, 0, 0, 0, 0, 7 ],
		    [ 7, 0, 0, 0, 0, 0, 3, 0, 0, 0, 3, 0, 0, 0, 7 ],
		    [ 7, 0, 0, 0, 0, 0, 0, 0, 0, 0, 0, 0, 0, 0, 7 ],
		    [ 7, 0, 0, 1, 0, 0, 0, 0, 0, 0, 0, 0, 0, 0, 7 ],
		    [ 7, 0, 0, 7, 0, 0, 0, 0, 0, 0, 0, 0, 0, 0, 7 ],
		    [ 7, 1, 0, 7, 0, 0, 0, 0, 0, 3, 3, 3, 0, 0, 7 ],
		    [ 7, 7, 1, 7, 1, 6, 6, 6, 1, 1, 1, 1, 1, 1, 7 ],
            [ 0, 0, 0, 0, 0, 4, 4, 4, 0, 0, 0, 0, 0, 0, 0 ]
	    ]
    },
	
	"spawns": [
		[2, 2],
		[1, 1],
		[6, 6],
		[3, 3],
		[4, 4]
	]
}