{
	"name": "Test 04: Outdated file format",
	"width": 10,
	"height": 10,
	"version": 1,
        
    "load": [
        "air",
        "wall",
        "floor",
        "game_machine"
    ],
	
	"tiles": [
		[ 1, 1, 1, 1, 2, 2, 2, 2, 2, 2, 2, 2, 1 ], 
		[ 1, 0, 0, 1, 0, 0, 0, 0, 0, 0, 0, 0, 1 ], 
		[ 1, 0, 0, 1, 0, 0, 0, 0, 3, 0, 0, 0, 1 ], 
		[ 1, 0, 0, 0, 0, 0, 0, 0, 0, 0, 0, 0, 1 ], 
		[ 1, 0, 0, 0, 0, 0, 3, 0, 0, 0, 3, 0, 1 ], 
		[ 1, 0, 0, 0, 0, 0, 0, 0, 0, 0, 0, 0, 1 ], 
		[ 1, 0, 0, 1, 0, 0, 0, 0, 0, 0, 0, 0, 1 ], 
		[ 1, 0, 0, 1, 0, 0, 0, 3, 0, 0, 0, 0, 1 ], 
		[ 1, 1, 0, 1, 0, 0, 0, 0, 0, 0, 0, 0, 1 ], 
		[ 1, 1, 1, 1, 1, 1, 1, 1, 1, 1, 1, 1, 1 ]
	],
	
	"spawns": [
		[2, 2],
		[1, 1],
		[6, 6],
		[3, 3],
		[4, 4]
	]
}