{
	"name": "Test 04",
	"width": 10,
	"height": 10,
	"version": 4,
        
    "load": [
        "AIR",
        "WALL",
        "FLOOR"
    ],
	
	"tiles": [
		[ 1, 2, 2, 2, 2, 2, 2, 2, 2, 0 ], 
		[ 1, 0, 0, 0, 0, 0, 0, 0, 0, 0 ], 
		[ 1, 0, 0, 0, 0, 0, 0, 0, 0, 0 ], 
		[ 1, 0, 0, 0, 0, 0, 0, 0, 0, 0 ], 
		[ 1, 0, 0, 0, 0, 0, 0, 0, 0, 0 ], 
		[ 1, 0, 0, 0, 0, 0, 0, 0, 0, 0 ], 
		[ 1, 0, 0, 0, 0, 0, 0, 0, 0, 0 ], 
		[ 1, 0, 0, 0, 0, 0, 0, 0, 0, 0 ], 
		[ 1, 0, 0, 0, 0, 0, 0, 0, 0, 0 ], 
		[ 1, 2, 2, 2, 2, 2, 2, 2, 2, 0 ]
	],
	
	"spawns": [
		[2, 2],
		[1, 1],
		[6, 6],
		[3, 3],
		[4, 4]
	]
}